...........
...........
..#######..
..#,,,,,#..
..#,,,,,#..
..,,,,,,#..
..#,,,,,#..
..#,,,,,#..
..#######..
...........
...........


